111111111111111111111111111111111111111
111111111111111111111111111111111111111
111111111111111B       B111111111111111
111111111111111         111111111111111
111111111111111B       B111111111111111
1111111111111111111 11111111111H H H H1
111111111111111111   1111111111 H H H 1
111111111                     1H H H H1
111111111                     9 H H H 1
111111111   6  6   6   6  6   1H H H H1
111111111                     1 H H H 1
111111111                     1H H H H1
111111111                     111111111
111111111   6    66666    6   111111111
111111111        66666        111111111
111111111        66666        111111111
111111111        66666        111111111
111111111   6    66666    6   111111111
111111111                     111111111
111111111                     111111111
1A A A A1                     111111111
1 A A A 1   6  6   6   6  6   111111111
1A A A A1                     111111111
1 A A A 9          M          111111111
1A A A A1                     111111111
1 A A A 1111111111   111111111111111111
1A A A A11111111111 1111111111111111111
1111111111111111111 1111111111111111111
111111111111111111H H111111111111111111
111111111111111111H A111111111111111111
111111111111111111H A111111111111111111
111111111111111111 P 111111111111111111
111111111111111111171111111111111111111
