111111111111111111111111111111117111111111111111111111111111
11111111111111111111111111111111 111111111111111111111111111
11111111111111111111111111111111 111111111111111111111111111
111111111111111111111111111111     1111111111111111111111111
111111111111111111111111111111     1111111111111111111111111
111111111111111111111111111111     1111111111111111111111111
11111111111111111        1111111 111111111111111111111111111
11111111111111111     11 1111111 111111111111111111111111111
11111111111111111     11      11 111111111111111111111111111
1111111111111111      11      11 111111111111111111111111111
111111111111111    11111         111111111111111111111111111
111111111111111    11111      111111111111111111111111111111
11111111111111    111111      11111      1111111111111111111
11111111111111      111111111111111      1111111111111111111
1111111111111    11 1111111111111        1111111111111111111
1111111111111    1    11111111111        1111111111111111111
111111111111    11    1111111            1111111111     1111
11111111111    111    1111111            1111111111 11111111
1111111111    11      1111111  11        1111111111     1111
111111111    111      1111111  11        11     111     1111
11111111    1111      111111    111111   11   1 111     1111
1111111    111111111111111        1111        1           11
11111     1111111111111111  1  1  1111   1111111111111111 11
11111    11111111111111111  1  1  11111111111111111111    11
11111    11  1111111111111  1  1  11111111111111111111 11111
11111    11  1111111111111  1  1  111111111111111111    1111
11111    11  1   1    1111  1  1  111111111111111111    1111
11111111 11      1    111   1  1   11111111111111111    1111
11111111 1         11                 11111111111111    1111
11111111           11                 11111111111111     111
11111111         11111111   1  1   11 11111 111111111    111
1111111111      1111111111  1  1  111 111     1111111    111
1111111111     11111111111  1  1  111 11       111111    111
1111111111    111111111111  1  1  111 1         1  11    111
11111111111111111    11111  1  1  111              11    111
11111111111111111    11111  1  1  11111         1  1111 1111
11111111111111       11111        111111       11111111 1111
11111111111111       11111        1111111     111111    1111
11111111111111       1111111    11111111111 11111111 1111111
11111111111111       11111111  111111111111 11111111 1111111
11111111111111                 111111111111          1111111
11111111111111                 11111111111111111111111111111
11111111111111       111111111111111111111111111111111111111
11111111             111111111111111111111111111111111111111
11111111       11111 11111111 111111111  b  1111111111111111
11111111       11111 11111G     G1111       1111111111111111
11111111       11111111111       1111 1A    1111111111111111
11111111       11111111111       1111 1HS   1111111111111111
11  1111       11111111111       1111 1111171111111111111111
11             111111111    G6G       1111111111111111111111
11   111       111111111 1       111111111111111111111111111
11   111       1111      1       111111111111111111111111111
11   111       1111      1   m   111111111111111111111111111
11   1111   1111111   1111G     G111111111111111111111111111
1    11111111111111  11111111S1111G A    b    l1111111111111
1    11111       11  11111111P1111    G11     b1111111111111
1   1111             11111111R1111  b  11  G   1111111111111
1   1111         11111111              11  T G 1111111111111
1                11111111 11111111     11 G  t 1111111111111
1                11111111 1l    l1    G11  G  b1111111111111
111111111       111111111 1 111G 1G H l11lG  bG R11111111111
1111111111 111 1111111111 1 1 11 111111111111111111111111111
1111111111 1G1 1111111111 1    1 111111111111111111111111111
11111111         11111111 11  11 111111111111111111111111111
11111111h      ba11111111 G1111G 111111111111111111111111111
11111111h b     a11111111l      l111111111111111111111111111
11111111h       a1111111111111111111111111111111111111111111
11111111h       a1111111111111111111111111111111111111111111
11111111h       a1111111111111111111111111111111111111111111
111111111       11111111111111111111111111111111111111111111
111111111111111111111111111111111111111111111111111111111111
