11111111111111111111111111111111111111111111111111111111111111111111
1111111111111111111l   G       Vl11111111111111111111111111111111111
1111111111111111111         V    11111111111111111111111111111111111
1111111111111111111     G        11111111111111111111111111111111111
1111111111111111111  G  111     h111111      11111111111111111111111
1111111111111111111     111V    h111111  G            G   1111111111
1111111111111111111     111 M   H1                G              H11
1111111111111111111    G111   bb 1   V 11   V111111     A         11
1111111111111111111     1119111111     11    11111111111111      G11
1111111111111111111     111A  SRM1 G   111111111111111111111      11
1111111111111111111  G  111A     1     111111111111111111111  G   11
1111111111111111111     111A  HHH1 1111111111111111111111111    1111
1111111111111111111    G1111111111 1111111111111111111111111    1111
1111111111111111111     1111111111 1111111111111111111111111    1111
1111111111111111111     1111111111 1111111111111111111111111 G  1111
1111111111111111111    11111111111 1111111111111111111111111    1111
1111111111111111 bb    11111111111 1111111111111111111111111    1111
1111111111111111a      1111   VV   G 11111111111111111111111  G 1111
1111111111111111a      1111       G  11111111111111111111111    1111
1111111111111111       1111 111     111111111111111111111111 G  1111
111111111111111111 11111111 11111111111111111111111111111111    1111
111111111111111111 111111   GG5111111111111111111111111111111 V11111
111111111111111111      9 V   5111111111111111111111111111111  11111
1111111111111111111111111b M  b111111111111111111111111111111  11111
1111111111111111111111111     b111111111111111111111111111111  11111
1111111   G5  V   G             55555511111111111111111111     11111
1111111    55        5                 V    11111111111111     11111
11111115a    G  5    55 V     5   GG     G  11111111111111  11111111
11111115A       55   5  bbbb 5 V    bb      11111111111111  11111111
11111115A        5   5  bbbb        bb      11111111111111  11111111
11111115A   5                       bb  G   11111111111111  11111111
1   R115A        55     b                   11111111111111  11111111
1P   11      H    5  V     b 5    5     H111111111111  111  11111111
1711 11                   b      55   G b111111111111  1111  1111111
1111              b    5   55           b11111           111  111111
1111111b G   5bb V      5               b11111  GG       1111  11111
1111111b  G 5555b55    V       5                      G  11111  1111
1111111     555555555   aaaaa V    5bb11111111        V  11111  1111
1111111111111111111111111111111111111111111111    V      11111  1111
1111111111111111111111111111111111111111111111aaa        111      11
111111111111111111111111111111111111111111111111111V11111111  G   11
111111111111111111111111111111111111111111111111111 11111111      11
111111111111111111111111111111111111111111111            111    G 11
111111111111111111111111111111111111111111111  111111111 111      11
111111111111111111111111111111111111111111111  G   11111 111   V  11
111111111111111111111111111111111111111111111      11111111111  1111
111111111111111111111111111111111111111111111      11111111111  1111
111111111111111111111111111111111111111111111   G  11111111111  1111
111111111111111111111111111111111111111111111 G    1111111111   E111
111111111111111111111111111111111111111111111    V 1111111111   E711
11111111111111111111111111111111111111111111111111111111111111111111
