111111111111111111111111111111117111111111111111111111111111
11111111111111111111111111111111E111111111111111111111111111
11111111111111111111111111111111E111111111111111111111111111
111111111111111111111111111111G   G1111111111111111111111111
111111111111111111111111111111  H  1111111111111111111111111
111111111111111111111111111111     1111111111111111111111111
11111111111111111V555  b 1111111 111111111111111111111111111
11111111111111111     11 1111111 111111111111111111111111111
11111111111111111V    11      11 111111111111111111111111111
1111111111111111     V11 G bV 11 111111111111111111111111111
111111111111111    11111         111111111111111111111111111
111111111111111  V 11111 V  G 111111111111111111111111111111
11111111111111V   111111      11111laaaa 1111111111111111111
11111111111111b     111111111111111     G1111111111111111111
1111111111111 V  11 1111111111111 G  V   1111111111111111111
1111111111111   V1G  11111111111         1111111111111111111
111111111111 V  11   l1111111G         G 1111111111  HHA1111
11111111111   b111    1111111  11 G  V   1111111111 11111111
1111111111b   11HHG   1111111  11  t   G 1111111111 G Gb1111
111111111  V 111AA   b111111    111111   11 G 55111  R b1111
11111111    1111b G  b1111        1111   11  G1 111  G  1111
1111111H   111111111111111  l  l  1111 G      1           11
11111A   b1111111111111111  1G 1  1111   1111111111111111 11
11111 V  11111111111111111 G1  1 G11111111111111111111    11
11111    11aa1111111111111  1 G1  11111111111111111111 11111
11111b   11aa1111111111111G 1  1G 111111111111111111  G 1111
11111    11G 1  l1    1111  1G 1  111111111111111111 G G1111
11111111 11   5 G1    111   1  1   11111111111111111    1111
11111111 1  G 5G   11                 11111111111111  G 1111
11111111    V   G  11        V        11111111111111G   G111
11111111  G      11111111   1  1   11 11111A111111111 G  111
1111111111    G 1111111111  1 G1  111 111     1111111    111
1111111111b G  11111111111 G1  1 G111 11       111111G G 111
1111111111   b111111111111  1G 1  111 1  G   G  1Ga11 G  111
11111111111111111aaaa11111G 1  1G 111     56      a1111 1111
11111111111111111    11111  1 G1  11111  G 5 G  1hh1111 1111
11111111111111   G   11111  l  l  111111       11111111 1111
11111111111111 Gl   l11111        1111111     111111    1111
11111111111111  t  V 1111111    11111111111 11111111 1111111
11111111111111  G  b 11111111  111111111111 11111111 1111111
11111111111111 l     G        G111111111111          1111111
11111111111111  G G        G   11111111111111111111111111111
11111111111111      b111111111111111111111111111111111111111
11111111  l       bt 111111111111111111111111111111111111111
11111111b  555 11111 11111111 111111111 Sbbb11    1111111111
11111111b   Gb 11111H11111       1111       9     1111111111
11111111b  V l 11111111111 G   G 1111 1A    1111111111111111
11111111b      11111111111       1111 1H   P1111111111111111
11A 1111b   5b 11111111111       1111 1111171111111111111111
11         b5b 111111111    G6G       1111111111111111111111
11h  111 l 55b 111111111 1       111111111111111111111111111
11h G111       1111hG    1       111111111111111111111111111
11h  111 G   G 1111h   G 1 G   G 111111111111111111111111111
11h G1111   1111111h  1111       111111111111111111111111111
1G   11111111111111h 11111111 1111G A    b    l1111111111111
1    11111G aaa 11   11111111 1111    G11 t  Gb1111111111111
1 G 1111G            11111111 1111  b  11  G   1111111111111
1   1111         11111111              11 Gt G 1111111111111
1  G        G    11111111 11111111  5  11 G  t 1111111111111
1     G          11111111 1l    l1    G11  G  b1111111111111
111111111G     G111111111 1 111G 1G H l11lG  b 1111111111111
1111111111 111 1111111111 1 1 11 111111111111111111111111111
1111111111 1G1 1111111111 1   H1 111111111111111111111111111
11111111         11111111 11 A11 111111111111111111111111111
11111111h      ba11111111 G1111G 111111111111111111111111111
11111111h b     a11111111l      l111111111111111111111111111
11111111h G     a1111111111111111111111111111111111111111111
11111111h       a1111111111111111111111111111111111111111111
11111111h    G  a1111111111111111111111111111111111111111111
111111111 G   G 11111111111111111111111111111111111111111111
111111111111111111111111111111111111111111111111111111111111
