11111111111111111113211211211211211111111111111111111111111111111111
1111111111111111111l   G       Vl11111111111111111111111111111111111
1111111111111111112         V    11111111111111111111111111111111111
1111111111111111111     G        21111113112111111111111111111111111
1111111111111111111  G  111     h111111      11121111121111111111111
1111111111111111112     111V    h111111  G            G   1111111111
1111111111111111111     111 M   H1                G              H11
1111111111111111111    G111   bb 2   V 11   V111211     A         31
1111111111111111112     1119111111     11    11111111121111      G11
1111111111111111111     111A  SRM1 G   111121111111111111111      11
1111111111111111111  G  111A     2     111111111111111111111  G   11
1111111111111111112     111A  HHH1 1111111111111111111111111    1111
1111111111111111113    G1111111111 1111111111111111111111111    1111
1111111111111111111     1111111111 1111111111111111111111112    2111
1111111111111111112     1111111111 1111111111111111111111111 G  1111
1111111111111111111    11111111111 1111111111111111111111111    1111
1111111111111111 bb    11111111111 1111111111111111111111111    1111
1111111111111111a      1111   VV   G 11111111111111111111112  G 2111
1111111111111111a      1111       G  11111111111111111111111    1111
1111111111111111       1111 111     111111111111111111111111 G  1111
111111111111111111  1111111 11111111111111111111111111111112    2111
111111111111111111  11111   GG5111111111111111111111111111111 V11111
111111111111111111      9 V   5111111111111111111111111111111  11111
1111111111111111111111111b M  b111111111111111111111111111112  21111
1111111112111131111112111     b111111111111111111111111111111  11111
1111113   G5  V   G             55555511113111111111111111     11111
1111111    55        5                 V    11111111111111     11111
11111115a    G  5    55 V     5   GG     G  21111111111111  11111111
11111115a       55   5  bbbb 5 V    bb      11111111111112  21111111
11111115a        5   5  bbbb        bb      11111111111111  11111111
11111115a   5                       bb  G   31111111111111  11111111
1   R115a        55     b                   11111111123112  21111111
1P   11      H    5  V     b 5    5     H111111111111aa111  11111111
1711 11                   b      55   G b111111211211hh1111  1111111
1111              b    5   55           b11111           111  111111
1111121b G   5bb V      5               b11111  GG       2111  11111
1111111b  G 5555b55    V       5                      G  11111  1111
1111111     555555555   hhhhh V    5bb11111111        V  11112  2111
1111111111311111111111111311211121111111111111    V      21111  1111
1111111111111111111111111111111111111111111111aaa        111      11
111111111111111111111111111111111111111111111112112V12111111  G   11
111111111111111111111111111111111111111111111111111 11111111      11
111111111111111111111111111111111111111111111            111    G 11
111111111111111111111111111111111111111111111  111111111 111      11
111111111111111111111111111111111111111111111  G   11111 111   V  11
111111111111111111111111111111111111111111111      11111111111  1111
111111111111111111111111111111111111111111112      21111111112  2111
111111111111111111111111111111111111111111111   G  11111111111  1111
111111111111111111111111111111111111111111111 G    1111111111   E111
111111111111111111111111111111111111111111111    V 1111111111   E711
11111111111111111111111111111111111111111111111111111111111111111111
