111111111111111111111111121121111111111
1111111111111111111111 b   b  121111111
1111111111111111111112    G     1111111
1111111111111111111111  11   G   111111
11111111111111211444111 211      111111
11111111111111EE1   121 1113    G 11111
11111111111117EE  S  G  2113      11111
11111111111111EE1   1211111     G111111
11111111111111211444111111       111111
11111aa11111111111111112A       1111111
11111aa11111111111111111G     121144444
111     1111111111111111 h  11111    H4
111        G111G   11111111 111  G    4
111  t      111HS   1111111  bb   G   4
1H1  1111   1111 G  111211         G  4
1    311h           11  11 5       1111
111  11h     11 1111111 G 1b       1111
11         G 33 112     AH1   h Gh11111
11 t       t 11 111  11 G 11 1111111111
1a     1    G1       2111111 121111 A21
11  T  G111 11 121 l 11   G       1 G11
11      11111l aa1      5    1211 1 111
11    111111  G a111111      1aG1   111
1111 1111112   G H2h h2      1    11111
1111111111111bb  1h G1  hl G1 h11 11111
1111111111121111111 1112131212111 11211
111111111a   G111l   l111   hhh5     l2
1111111111    1         1  G5      G  1
1111111111         2        5  Gb     2
1111111111    1         1        t   b1
111111111a   G11       11           G 1
11111111111111111l   l111   b55      b2
1111111111121111111 11111    55   aaa 1
111111111111111111   111111111111212111
111111111111111112 P 211111111111111111
111111111111111111171111111111111111111
