111111111111111111111111121121111111111
1111111111111111111111 b   b  121111111
1111111111111111111112 G  G     1111111
1111111111111111111111  11   G   111111
11111111117111211444111 211G     111111
111111111EEE11EE1   121G1113    G 11111
111111111EEE17EE  S  G  2113      11111
111111111aaa11EE1   1291111     G111111
111111111  G1121144411 111      111111
11111aa11G    11111111 2A     G 1111111
11111aa1111         RH 1G    G121144444
111    G1111111111111111 h  11111    H4
111        G111G   11111111 111  G    4
111  t     G111HS   1111111  bb   G   4
1H1 G1111   1111 G  111211         G  4
1    311h           111 11 5    G  1111
111  11h     11 1111111 G 1b       1111
11         G 33 112     AH1   h Gh11111
11 t       t 11 111  11 G 11 1111111111
1a     1  G G1       2111111 121111GA21
11  T  G111 11 121 l 11   G       1 G11
11   G  11111l aa1      5    1211 1 111
11 G  111111  G a111111    G 1aG1   111
1111 1111112   GH2h A2       1    121a1
1111111111111bb  1h G1  hl  G1 h1 9  S1
1111111111121111111 1112131212111 111a1
111111111a   G111l   l111  hhhG55 12112
1111111111    1         1   5      G  1
1111111111         2        5   b     2
1111111111  G 1         1        t   b1
111111111h    11       11 G         G 1
11111111111111111l   l111   b55      b2
1111111111121111111 11111    55 G aaa 1
111111111111111111   111111111111212111
111111111111111112 P 211111111111111111
111111111111111111171111111111111111111
