1221111111111111111111111111111111111111111111
1EE1111111111  m m m  hh1       1            1
1  11111mmm11 l l l l   1             m      1
1           1           1                    1
1                       1 t     1  t    t    1
1 m         1           1    m  1         a  1
1 m         1                   1         a  1
1    mmmmmm 1           1       1 m       a  1
1111311111111112112112111       1         a  1
1111111111111l         l1    m  1            1
1111111111111 V   V   V 1      l1   t        1
1111111111113           1 1111111         t  1
1111113111111   66 66   1   mmmH1      m     1
1   hh    111   6H A6   111 mmmH1 m          1
1           1 V 6H  6 V 311 mmmm1           t1
1           1   6 B 6   11211111111111  111111
1         1 1   66666   1l                  a1
1 P      S1 1     M     1    m               1
1         1 1                                1
1         1 1   V   V   1    m               1
1   aa  G 1 1l         l1h                  l1
11121121121 11111  111111111 111111  111 11111
1   bbbb       H1  11            t          h1
1 G             1  21                        1
1            R  1  11        t  m  t         1
1 G     l          11                 t      1
1               1  11           t     t      1
1 G 5G G G G G  1  21         m        m     1
1    5       5  1  11                      aa1
155    aaaaa    1  11          m     t     aa1
1111211211211211113111111111111111111111111111
