1111111111
1    M   1
1        1
1 M  P  M1
1        1
1    M   1
1        1
1111111111
