1221111111111111111111111111111111111111111111
1  1111111111  M M M  hh1       1            1
1  11111MMM11 l l l l   1             M      1
1           1           1                    1
1                       1 t     1  t    t    1
1 M         1           1    M  1         a  1
1 M         1                   1         a  1
1    MMMMMM 1           1       1 M       a  1
1111111111111111111111111       1         a  1
1111111111111l         l1    M  1            1
1111111111111 M   M   M 1      l1   t        1
1111111111111           1 1111111         t  1
1111111111111   11 11   1   MMMH1      M     1
1   hh  M 111   1H A1   111 MMMH1 M          1
1           1 M 1   1 M 1   MMMM1           t1
1           1   1 M 1   11111111111111  111111
1         1 1   11111   1l                  a1
1 P       1 1           1    M               1
1         1 1           1                    1
1         1 1   M   M   1    M               1
1   aa  M 1 1l         l1h                  l1
11111111111 111111  11  1  11111111  111111111
1               H1  11           t          h1
1 M              1  11                       1
1                1  11       t  M  t         1
1 M                 11                t      1
1                1  11          t     t      1
1 M  M   M  M  M 1  11        M        M     1
1                1  11                     aa1
1       aaaaa    1  11         M     t     aa1
1111111111111111111111111111111111111111111111
